MOVIE TITLE,RELEASE YEAR,RUNTIME,IMDB RATING,IMDB VOTES,WORLDWIDE GROSS,ESTIMATED BUDGET,PROFIT,MOVIE REVIEW
Avengers: Endgame,2019,181,8.4,748670,2797800564,356000000,2441800564,1
Avengers: Infinity War,2018,149,8.4,792818,2048709917,321000000,1727709917,0
Harry Potter and the Deathly Hallows: Part 2,2011,130,8.1,741462,1341511219,125000000,1216511219,0
The Lord of the Rings: The Return of the King,2003,201,8.9,1600809,1119929521,94000000,1025929521,0
Joker,2019,122,8.5,842794,1074251311,55000000,1019251311,0
Jurassic Park,1993,127,8.1,902597,1029153882,63000000,966153882,0
The Lion King,1994,88,8.5,977800,968483777,45000000,923483777,0
Toy Story 3,2010,103,8.3,738152,1068879522,200000000,868879522,0
Finding Nemo,2003,100,8.1,926000,936743261,94000000,842743261,1
The Dark Knight Rises,2012,164,8.4,1476788,1084939099,250000000,834939099,0
The Lord of the Rings: The Two Towers,2002,179,8.7,1446565,926047111,94000000,832047111,1
The Dark Knight,2008,152,9,2235487,1004558444,185000000,819558444,1
The Lord of the Rings: The Fellowship of the Ring,2001,178,8.8,1616442,871530324,93000000,778530324,0
Star Wars: Episode IV - A New Hope,1977,121,8.6,1201831,775398007,11000000,764398007,0
Inside Out,2015,95,8.1,590815,857611174,175000000,682611174,1
Inception,2010,148,8.8,1994355,825532764,160000000,665532764,0
The Sixth Sense,1999,107,8.1,892662,672806292,40000000,632806292,1
Coco,2017,105,8.4,350108,807082196,175000000,632082196,0
Forrest Gump,1994,142,8.8,1891012,677945399,55000000,622945399,1
Up,2009,96,8.2,909295,731342744,175000000,556342744,1
The Lost World: Jurassic Park,1997,129,6.6,392359,618638999,73000000,545638999,0
Logan,2017,137,8.1,625437,619021436,97000000,522021436,1
Home Alone,1990,103,7.6,505064,533800000,18000000,515800000,1
Interstellar,2014,169,8.6,1442468,675020017,165000000,510020017,1
Men in Black,1997,98,7.3,532718,589390539,90000000,499390539,0
Aladdin,1992,90,8,385140,504050219,28000000,476050219,0
Jaws,1975,124,8,561484,470653000,8000000,462653000,1
Pretty Woman,1990,119,7,302048,463406268,14000000,449406268,0
The Last Supper,1995,92,6.8,14540,463406268,14000000,449406268,1
Jane Eyre,1996,112,6.8,9374,463406268,14000000,449406268,0
"Monsters, Inc.",2001,92,8,793280,562816256,115000000,447816256,1
Mrs. Doubtfire,1993,125,7,254341,441286195,25000000,416286195,0
Snow White and the Seven Dwarfs,1937,83,7.6,188614,418200000,2000000,416200000,0
Saving Private Ryan,1998,169,8.6,1200775,481840909,70000000,411840909,1
Twister,1996,113,6.4,185777,494471524,92000000,402471524,0
Maya Lin: A Strong Clear Vision,1994,105,7.4,479,494471524,92000000,402471524,0
Dances with Wolves,1990,181,8,249044,424200000,22000000,402200000,0
The Matrix,1999,136,8.7,1628084,463517383,63000000,400517383,1
Beauty and the Beast,1991,84,8,426837,424967620,25000000,399967620,1
Gone with the Wind,1939,238,8.1,300142,400176459,3977000,396199459,0
Grease,1978,110,7.2,251751,394955690,6000000,388955690,0
Mission: Impossible,1996,110,7.1,400708,457696359,80000000,377696359,1
Batman,1989,126,7.5,350024,411348924,35000000,376348924,0
Raiders of the Lost Ark,1981,115,8.4,863621,389925971,18000000,371925971,1
Back to the Future,1985,116,8.5,1105235,381109762,19000000,362109762,1
WALLÂ·E,2008,98,8.4,972534,534767889,180000000,354767889,1
Gladiator,2000,155,8.5,1304930,457640427,103000000,354640427,1
Toy Story,1995,81,8.3,921693,373554033,30000000,343554033,1
Top Gun,1986,110,6.9,308722,356830601,15000000,341830601,0
The Mask,1994,101,6.9,360482,351583407,18000000,333583407,0
How to Train Your Dragon,2010,98,8.1,650100,494878759,165000000,329878759,1
Django Unchained,2012,165,8.4,1314316,425368238,100000000,325368238,1
The Fugitive,1993,130,7.8,277393,368875760,44000000,324875760,0
Speed,1994,116,7.2,342753,350448145,30000000,320448145,0
Gone Girl,2014,149,8.1,830718,369330363,61000000,308330363,1
Basic Instinct,1992,127,7,187791,352700000,49000000,303700000,0
Apollo 13,1995,140,7.6,279162,355237933,52000000,303237933,0
Catch Me If You Can,2002,141,8.1,797411,352114312,52000000,300114312,1
Green Book,2018,130,8.2,338783,322720649,23000000,299720649,0
Se7en,1995,127,8.6,1398169,327311859,33000000,294311859,1
GoldenEye,1995,130,7.2,244568,352194034,60000000,292194034,0
The Wolf of Wall Street,2013,180,8.2,1137603,392000694,100000000,292000694,1
Spider-Man: Into the Spider-Verse,2018,117,8.4,332891,375540831,90000000,285540831,0
The Sound of Music,1965,172,8,215064,286214286,8200000,278014286,0
1917,2019,119,8.3,356182,368027644,100000000,268027644,1
Ghost,1990,127,7.1,204430,290000000,22000000,268000000,0
True Lies,1994,141,7.2,246491,378882411,115000000,263882411,0
The Rock,1996,136,7.4,321608,335062621,75000000,260062621,0
Liar Liar,1997,86,6.9,291388,302710615,45000000,257710615,0
Spirited Away,2001,125,8.6,624110,274925095,19000000,255925095,1
A Beautiful Mind,2001,135,8.2,825704,313542341,58000000,255542341,1
The Hunchback of Notre Dame,1996,91,7,147529,325338851,70000000,255338851,0
The Full Monty,1997,91,7.2,102098,257938649,3500000,254438649,0
The Silence of the Lambs,1991,118,8.6,1323198,272742922,19000000,253742922,1
101 Dalmatians,1996,103,5.7,107081,320689294,75000000,245689294,1
Four Weddings and a Funeral,1994,117,7.1,144798,245700832,4400000,241300832,0
The Godfather,1972,175,9.2,1693761,245066411,6000000,239066411,1
Inglourious Basterds,2009,153,8.3,1226512,313600000,75000000,238600000,1
Casper,1995,100,6.1,126132,287928194,50000000,237928194,0
Gran Torino,2008,116,8.1,705741,269958228,33000000,236958228,1
Air Force One,1997,124,6.5,186620,315156409,85000000,230156409,0
Star Wars: Episode V - The Empire Strikes Back,1980,124,8.7,1129708,247916602,18000000,229916602,1
Ransom,1996,121,6.7,122182,309492681,80000000,229492681,0
Bean,1997,89,6.5,100678,251212670,22000000,229212670,0
Mad Max: Fury Road,2015,120,8.1,853945,378436354,150000000,228436354,1
The Firm,1993,154,6.8,125826,270248367,42000000,228248367,0
The Green Mile,1999,189,8.6,1109319,286801374,60000000,226801374,1
Batman Begins,2005,140,8.2,1274636,374218673,150000000,224218673,1
Babe,1995,91,6.8,120203,254134910,30000000,224134910,0
Rocky,1976,120,8.1,505197,225000000,960000,224040000,1
Jerry Maguire,1996,139,7.3,250662,273552592,50000000,223552592,0
Gattaca,1997,106,7.8,288512,257938649,36000000,221938649,0
The Nutty Professor,1996,95,5.6,113127,273961019,54000000,219961019,0
Good Will Hunting,1997,126,8.3,894884,225933435,10000000,215933435,1
Shutter Island,2010,138,8.2,1092728,294804195,80000000,214804195,1
Terminator 2: Judgment Day,1991,137,8.5,1028410,315000000,102000000,213000000,1
Jumanji,1995,104,7,321036,262797249,50000000,212797249,0
American Beauty,1999,122,8.3,1047150,226200000,15000000,211200000,0
Howl's Moving Castle,2004,119,8.2,317521,235184110,24000000,211184110,0
Life Is Beautiful,1997,116,8.6,604006,229163264,20000000,209163264,1
Pulp Fiction,1994,154,8.9,1896750,213928762,8000000,205928762,1
Priest,1994,105,7.1,9998,213928762,8000000,205928762,0
The Truman Show,1998,103,8.1,982015,264118201,60000000,204118201,1
Chungking Express,1994,102,8.1,70364,264118201,60000000,204118201,0
The Departed,2006,151,8.5,1156918,289847354,90000000,199847354,1
Schindler's List,1993,195,8.9,1258969,221000000,22000000,199000000,0
Alien,1979,117,8.4,818204,203630630,11000000,192630630,0
The Help,2011,146,8,418705,216639112,25000000,191639112,0
Million Dollar Baby,2004,132,8.1,621954,216763646,30000000,186763646,1
Ace Ventura: When Nature Calls,1995,90,6.4,207878,212385533,30000000,182385533,0
The Flintstones,1994,91,4.9,78262,228000000,46000000,182000000,0
Ben-Hur,1959,212,8.1,227530,196200000,15900000,180300000,0
2001: A Space Odyssey,1968,149,8.3,626121,190700000,12000000,178700000,1
The Hunt for Red October,1990,135,7.6,187099,200512643,30000000,170512643,0
Space Jam,1996,88,6.5,187116,250200000,80000000,170200000,0
Die Hard 2,1990,124,7.1,346082,240031094,70000000,170031094,0
The Santa Clause,1994,97,6.5,103336,189800000,22000000,167800000,0
12 Years a Slave,2013,134,8.1,623082,187733202,20000000,167733202,1
Scream,1996,111,7.3,298770,173046663,14000000,159046663,0
Disclosure,1994,128,6.1,48118,214015089,55000000,159015089,0
Eat Drink Man Woman,1994,124,7.8,19749,214015089,55000000,159015089,0
The Bridges of Madison County,1995,135,7.6,76398,182016617,24000000,158016617,0
Jeffrey,1995,92,6.8,6043,182016617,24000000,158016617,0
Dangerous Minds,1995,99,6.5,50555,179519401,23000000,156519401,0
The First Wives Club,1996,103,6.4,45631,181489203,26000000,155489203,0
The Birdcage,1996,117,7.1,83859,185260553,31000000,154260553,0
Clear and Present Danger,1994,141,6.9,93919,215887717,62000000,153887717,0
Kill Bill: Vol. 1,2003,111,8.1,975105,180949045,30000000,150949045,1
The Grand Budapest Hotel,2014,99,8.1,685799,174600318,25000000,149600318,1
Con Air,1997,115,6.9,284188,224012234,75000000,149012234,0
Scream 2,1997,120,6.2,163129,172363301,24000000,148363301,0
No Country for Old Men,2007,122,8.1,829019,171627166,25000000,146627166,1
"Three Billboards Outside Ebbing, Missouri",2017,115,8.2,409729,160191915,15000000,145191915,1
Unforgiven,1992,130,8.2,389605,159157447,14400000,144757447,0
Dirty Dancing,1987,100,7,213352,150000000,6000000,144000000,0
City of Angels,1998,114,6.7,116486,198685114,55000000,143685114,0
Eraser,1996,115,6.1,106567,242295562,100000000,142295562,0
Stargate,1994,116,7.1,181502,196600000,55000000,141600000,0
The Lawnmower Man,1992,108,5.4,34867,150000000,10000000,140000000,0
Unhook the Stars,1996,103,6.6,2164,150000000,10000000,140000000,0
Outbreak,1995,127,6.6,124161,189859560,50000000,139859560,0
Cool Runnings,1993,98,7,97158,154856263,15000000,139856263,0
Hacksaw Ridge,2016,139,8.1,416620,175302354,40000000,135302354,1
Free Willy,1993,112,6,71796,153698625,20000000,133698625,0
Star Wars: Episode VI - Return of the Jedi,1983,131,8.3,926155,165800000,32500000,133300000,1
Legends of the Fall,1994,133,7.5,155445,160638883,30000000,130638883,0
Ford v Ferrari,2019,152,8.1,246697,225507881,97600000,127907881,0
The Horse Whisperer,1998,169,6.6,40082,186883563,60000000,126883563,0
The Journey of August King,1995,91,6.5,975,186883563,60000000,126883563,0
The Neon Bible,1995,91,6.1,828,186883563,60000000,126883563,0
Catwalk,1995,95,6.9,308,186883563,60000000,126883563,0
My Best Friend's Wedding,1997,105,6.3,134822,172168576,46000000,126168576,0
The Specialist,1994,110,5.6,64064,170400000,45000000,125400000,0
Dead Poets Society,1989,128,8.1,445707,140000000,16400000,123600000,1
Bad Boys,1995,119,6.9,248973,141407024,19000000,122407024,0
Sleepers,1996,147,7.6,205675,165615285,44000000,121615285,0
Under Siege,1992,103,6.5,81386,156400000,35000000,121400000,0
Phenomenon,1996,123,6.4,76508,152036382,32000000,120036382,0
George of the Jungle,1997,92,5.5,74172,174463257,55000000,119463257,1
Sense and Sensibility,1995,136,7.7,108369,135000000,16000000,119000000,1
Event Horizon,1997,96,6.7,167181,174463257,60000000,114463257,0
Batman & Robin,1997,125,3.8,240182,238207122,125000000,113207122,0
Die Hard,1988,132,8.2,817022,140767956,28000000,112767956,1
Aliens,1986,137,8.3,674973,131060248,18500000,112560248,1
A Time to Kill,1996,149,7.5,139553,152266007,40000000,112266007,0
The Graduate,1967,106,8,261542,114945305,3000000,111945305,0
Tomorrow Never Dies,1997,119,6.5,185833,221300000,110000000,111300000,0
Mary Poppins,1964,139,7.8,162859,115272727,6000000,109272727,0
Hot Shots! Part Deux,1993,86,6.6,87149,133752825,25000000,108752825,0
I Know What You Did Last Summer,1997,101,5.7,137472,125586134,17000000,108586134,0
Fried Green Tomatoes,1991,130,7.7,70085,119418501,11000000,108418501,0
Maverick,1994,127,7,106373,183031272,75000000,108031272,0
Brother Minister: The Assassination of Malcolm X,1994,115,7.3,100,183031272,75000000,108031272,0
Star Trek IV: The Voyage Home,1986,119,7.3,81619,133000000,25000000,108000000,0
The English Patient,1996,162,7.4,183447,134700000,27000000,107700000,0
Days of Thunder,1990,107,6.1,83230,165900000,60000000,105900000,0
A Perfect Candidate,1996,105,7.2,270,165900000,60000000,105900000,0
The Bloody Child,1996,85,4.4,138,165900000,60000000,105900000,0
Gandhi,1982,191,8,223125,127767889,22000000,105767889,0
The Wedding Singer,1998,97,6.9,140401,123306987,18000000,105306987,0
A Perfect World,1993,138,7.5,76783,135200000,30000000,105200000,0
Star Trek: First Contact,1996,111,7.6,120940,150000000,45000000,105000000,0
Mortal Kombat,1995,101,5.8,113618,122195920,18000000,104195920,0
Congo,1995,109,5.2,44156,152022101,50000000,102022101,0
Cliffhanger,1993,113,6.4,123587,171000000,70000000,101000000,0
Broken Arrow,1996,108,6,93918,150270147,50000000,100270147,0
The Young Poisoner's Handbook,1995,99,7.1,3557,150270147,50000000,100270147,0
The Jackal,1997,124,6.4,111706,159330280,60000000,99330280,0
Flubber,1997,93,5.3,86685,177977226,80000000,97977226,0
Ace Ventura: Pet Detective,1994,86,6.9,285879,107217396,12000000,95217396,0
Alien 3,1992,114,6.5,286171,159773600,66000000,93773600,0
Audrey Rose,1977,113,5.8,5782,159773600,66000000,93773600,0
Star Trek: The Motion Picture,1979,132,6.4,85597,139000000,46000000,93000000,0
L.A. Confidential,1997,138,8.2,549289,126216940,35000000,91216940,1
Boomerang,1992,117,5.6,28475,131100000,40000000,91100000,0
The Addiction,1995,82,6.5,9496,131100000,40000000,91100000,0
Man of the Year,1995,86,5.9,330,131100000,40000000,91100000,0
Donnie Brasco,1997,127,7.7,289543,124909762,35000000,89909762,0
Anastasia,1997,94,7.2,116270,139804348,50000000,89804348,0
Waterworld,1995,135,6.2,187245,264218220,175000000,89218220,0
The Net,1995,114,5.9,63015,110627965,22000000,88627965,0
Cop Land,1997,105,6.9,89626,97169156,10000000,87169156,0
Alien: Resurrection,1997,109,6.2,236388,161376068,75000000,86376068,0
The Pianist,2002,150,8.5,705963,120072577,35000000,85072577,1
Star Trek: Generations,1994,118,6.6,78791,120000000,35000000,85000000,0
Get Shorty,1995,105,6.9,80020,115101622,30250000,84851622,0
While You Were Sleeping,1995,103,6.7,95628,101000000,17000000,84000000,0
Mr. Holland's Opus,1995,143,7.3,36926,106269971,23000000,83269971,0
Sneakers,1992,126,7.1,56084,105233000,23000000,82233000,0
Nell,1994,112,6.5,28339,106683817,24500000,82183817,0
"Corrina, Corrina",1994,115,6.6,12854,106683817,24500000,82183817,0
Contact,1997,150,7.5,262255,171120329,90000000,81120329,0
Sleepless in Seattle,1993,105,6.8,165960,101200000,21000000,80200000,0
V for Vendetta,2005,132,8.2,1007469,132511035,54000000,78511035,1
Species,1995,108,5.8,77493,113374103,35000000,78374103,0
Spotlight,2015,129,8.1,405351,98275238,20000000,78275238,1
Sliver,1993,107,5.1,30203,116300000,40000000,76300000,0
Prisoners,2013,153,8.1,579118,122126687,46000000,76126687,1
The Lives of Others,2006,137,8.4,348687,77356819,2000000,75356819,0
Timecop,1994,99,5.9,57580,101646581,27000000,74646581,0
Striptease,1996,115,4.5,44396,113309743,40000000,73309743,0
Primal Fear,1996,129,7.7,198004,102616183,30000000,72616183,0
First Knight,1995,134,6,70315,127600435,55000000,72600435,0
The Client,1994,119,6.7,63123,117600000,45000000,72600000,0
Rising Sun,1993,125,6.3,43922,107198790,35000000,72198790,0
Dead Man Walking,1995,122,7.5,91448,83088295,11000000,72088295,0
Amistad,1997,155,7.3,73810,108060970,36000000,72060970,0
The Crow,1994,102,7.6,171877,94000000,23000000,71000000,0
Star Trek III: The Search for Spock,1984,105,6.7,77190,87000000,17000000,70000000,0
The Prestige,2006,130,8.5,1151509,109676311,40000000,69676311,1
Cape Fear,1991,128,7.3,181944,103200000,35000000,68200000,0
Jaws 3-D,1983,99,3.7,41619,87987055,20500000,67487055,0
Bastard Out of Carolina,1996,98,7.4,4277,87987055,20500000,67487055,0
Pocahontas,1995,81,6.7,176438,122195920,55000000,67195920,0
Mary Shelley's Frankenstein,1994,123,6.4,53093,112006296,45000000,67006296,0
Executive Decision,1996,133,6.4,52903,121969216,55000000,66969216,0
Star Trek VI: The Undiscovered Country,1991,110,7.2,72743,96888996,30000000,66888996,0
Waiting to Exhale,1995,124,6,10266,81452156,16000000,65452156,0
Beverly Hills Cop III,1994,104,5.6,78856,119208989,55000000,64208989,0
Black Beauty,1994,88,6.6,9677,119208989,55000000,64208989,1
Jackie Brown,1997,154,7.5,328386,74727492,12000000,62727492,0
Lawrence of Arabia,1962,228,8.3,278080,77324144,15000000,62324144,1
Dante's Peak,1997,108,6,85771,178127760,116000000,62127760,1
Conspiracy Theory,1997,135,6.7,96726,136982834,75000000,61982834,0
Capernaum,2018,126,8.4,52444,65814181,4000000,61814181,0
Seven Years in Tibet,1997,136,7.1,135539,131457682,70000000,61457682,0
Wolf,1994,125,6.2,54318,131002597,70000000,61002597,1
Andhadhun,2018,139,8.3,64955,65276927,4500000,60776927,0
The Peacemaker,1997,124,6,55895,110463140,50000000,60463140,0
Heat,1995,170,8.2,602335,120000000,60000000,60000000,1
Das Boot,1981,149,8.3,225847,73482661,14000000,59482661,0
The Game,1997,129,7.7,365960,109423648,50000000,59423648,0
Hard Target,1993,97,6.2,48274,74189677,18000000,56189677,0
Lost in Space,1998,130,5.2,70633,136159423,80000000,56159423,1
The Cable Guy,1996,96,6.1,158177,102825796,47000000,55825796,0
Courage Under Fire,1996,116,6.6,52145,100860818,46000000,54860818,1
Eternal Sunshine of the Spotless Mind,2004,108,8.3,887559,73169222,20000000,53169222,1
Batman Forever,1995,121,5.4,240449,152500000,100000000,52500000,0
Last Action Hero,1993,130,6.4,143262,137298489,85000000,52298489,0
The Man Without a Face,1993,115,6.7,28678,137298489,85000000,52298489,0
Rush,2013,123,8.1,421896,90247624,38000000,52247624,1
There Will Be Blood,2007,158,8.2,501482,77208711,25000000,52208711,1
Austin Powers: International Man of Mystery,1997,94,7,228748,67683989,17000000,50683989,0
Wag the Dog,1997,97,7.1,81069,64217092,15000000,49217092,1
Junior,1994,109,4.6,66857,108431355,60000000,48431355,0
In & Out,1997,90,6.4,40222,83256929,35000000,48256929,0
Spawn,1997,96,5.2,65791,87840042,40000000,47840042,0
The Assignment,1997,119,6.9,9136,87840042,40000000,47840042,0
Incognito,1997,108,6.5,3596,87840042,40000000,47840042,0
Wonderland,1997,104,7,132,87840042,40000000,47840042,1
G.I. Jane,1997,125,6,76938,97169156,50000000,47169156,0
Mighty Morphin Power Rangers: The Movie,1995,95,5.2,26312,66433194,20000000,46433194,0
Daylight,1996,114,5.9,70424,126189000,80000000,46189000,0
Marked for Death,1990,93,6,20904,57968936,12000000,45968936,0
Whiplash,2014,106,8.5,688309,48982041,3300000,45682041,1
In the Line of Fire,1993,128,7.2,97126,85000000,40000000,45000000,0
Under Siege 2: Dark Territory,1995,100,5.5,45245,104324083,60000000,44324083,0
Demolition Man,1993,115,6.7,164979,101000000,57000000,44000000,0
Fatal Instinct,1993,91,5.8,7179,101000000,57000000,44000000,1
Escape from New York,1981,99,7.2,132833,50000000,6000000,44000000,0
Judge Dredd,1995,96,5.6,113738,113493481,70000000,43493481,0
Sphere,1998,134,6.1,103368,123306987,80000000,43306987,0
Fearless,1993,122,7.1,21994,48424341,6000000,42424341,0
The Paper,1994,112,6.7,13613,48424341,6000000,42424341,1
Star Trek V: The Final Frontier,1989,107,5.5,57741,70210000,27800000,42410000,0
Into the Wild,2007,148,8.1,559434,56255142,15000000,41255142,1
Scarface,1983,170,8.3,719426,65884703,25000000,40884703,1
The Saint,1997,116,6.2,64904,108060970,68000000,40060970,0
The MatchMaker,1997,97,6.5,5561,108060970,68000000,40060970,0
Batman Returns,1992,126,7,283853,120000000,80000000,40000000,0
"The Adventures of Priscilla, Queen of the Desert",1994,104,7.5,48185,42300000,3000000,39300000,1
Muriel's Wedding,1994,106,7.2,37002,42300000,3000000,39300000,0
The Secret in Their Eyes,2009,129,8.2,187322,40527719,2000000,38527719,0
Made in America,1993,111,5.1,16240,60000000,22000000,38000000,0
Evita,1996,135,6.3,34813,91000000,55000000,36000000,0
Rear Window,1954,112,8.5,462121,36888916,1000000,35888916,1
Carlito's Way,1993,144,7.9,207467,63848322,30000000,33848322,0
The Terminator,1984,107,8,818312,40000000,6400000,33600000,0
The Shawshank Redemption,1994,142,9.3,2446424,58500000,25000000,33500000,0
Assassins,1995,132,6.3,79993,83306268,50000000,33306268,0
Fear,1996,97,6.2,44751,53192700,20000000,33192700,0
Eye for an Eye,1996,101,6.2,15597,53192700,20000000,33192700,1
Mercury Rising,1998,111,6.1,71281,93107289,60000000,33107289,0
Wild Tales,2014,122,8.1,169717,36353750,3300000,33053750,0
Volcano,1997,104,5.5,73881,122823468,90000000,32823468,0
The Beverly Hillbillies,1993,92,5,17927,57405220,25000000,32405220,0
Little Big League,1994,119,6.1,10363,57405220,25000000,32405220,0
Lassie,1994,94,5.9,6028,57405220,25000000,32405220,0
Rumble in the Bronx,1995,104,6.8,40582,39748899,7500000,32248899,0
Monty Python's Life of Brian,1979,94,8.1,379773,36045115,4000000,32045115,0
Hachi: A Dog's Tale,2009,93,8.1,245112,47707417,16000000,31707417,0
Mars Attacks!,1996,106,6.3,215798,101371017,70000000,31371017,0
The Big Lebowski,1998,117,8.1,761428,46189568,15000000,31189568,0
How to Make an American Quilt,1995,117,6.3,11268,41174130,10000000,31174130,0
Georgia,1995,115,6.6,2975,41174130,10000000,31174130,1
Spice World,1997,93,3.5,35124,56042592,25000000,31042592,0
Tin Cup,1996,135,6.4,47769,75900000,45000000,30900000,0
Memento,2000,113,8.4,1095610,39723096,9000000,30723096,1
Great Expectations,1998,111,6.8,52438,55494066,25000000,30494066,0
Vermin,1998,80,6,9,55494066,25000000,30494066,1
Night of the Living Dead,1968,96,7.9,121037,30000000,114000,29886000,1
Picnic,1955,115,7.1,8413,30000000,114000,29886000,0
Sabrina,1995,127,6.3,38385,87313761,58000000,29313761,0
Fargo,1996,98,8.1,640203,36000000,7000000,29000000,0
The Usual Suspects,1995,106,8.5,1023449,34449356,6000000,28449356,0
The Quest,1996,95,5.6,25239,57400547,30000000,27400547,0
Maximum Risk,1996,101,5.5,21299,51702483,25000000,26702483,0
Anaconda,1997,89,4.8,100069,71000000,45000000,26000000,0
Friday,1995,91,7.3,104341,28215918,3500000,24715918,0
Madonna: Truth or Dare,1991,120,6.3,9124,29012935,4500000,24512935,0
A Separation,2011,123,8.3,213557,24426169,500000,23926169,0
Room,2015,118,8.1,355729,36262783,13000000,23262783,0
The Shadow,1994,108,6.1,24483,48055248,25000000,23055248,0
The Celluloid Closet,1995,102,7.8,6696,48055248,25000000,23055248,0
Andre,1994,95,5.7,6652,48055248,25000000,23055248,0
A Great Day in Harlem,1994,60,7.4,444,48055248,25000000,23055248,0
Cat on a Hot Tin Roof,1958,108,8,47154,25472824,3000000,22472824,1
Reality Bites,1994,99,6.6,47770,33351557,11500000,21851557,1
A Man of No Importance,1994,99,6.7,1097,33351557,11500000,21851557,0
Grave of the Fireflies,1988,89,8.5,224326,25220794,3700000,21520794,1
Before Sunrise,1995,101,8.1,284763,22600000,2500000,20100000,0
The Abyss,1989,140,7.5,169355,90000098,70000000,20000098,0
Jean de Florette,1986,120,8,24878,90000098,70000000,20000098,1
Metro,1997,117,5.5,26753,74387563,55000000,19387563,0
North by Northwest,1959,136,8.3,310510,22213000,3101000,19112000,0
The Juror,1996,118,5.7,17981,63054725,44000000,19054725,0
Hotel Rwanda,2004,121,8.1,328671,36532987,17500000,19032987,0
Kids,1995,91,7.1,75487,20000000,1500000,18500000,0
Shallow Grave,1994,89,7.3,58860,20500000,2500000,18000000,1
I Love Trouble,1994,123,5.3,11813,61947267,45000000,16947267,0
American History X,1998,119,8.5,1012079,23875127,7500000,16375127,0
Starship Troopers,1997,129,7.2,278306,121214377,105000000,16214377,0
Home Alone 3,1997,102,4.5,110008,48200000,32000000,16200000,0
The Craft,1996,101,6.4,84780,30900000,15000000,15900000,0
Fierce Creatures,1997,93,6.4,24022,40381260,25000000,15381260,0
The Hunt,2012,115,8.3,268565,18309793,3800000,14509793,0
From Dusk Till Dawn,1996,108,7.2,296591,33500000,19000000,14500000,0
Reservoir Dogs,1992,99,8.3,952550,14831693,1200000,13631693,0
Witness for the Prosecution,1957,116,8.4,104032,16350000,3000000,13350000,1
Before Sunset,2004,80,8,227977,15992615,2700000,13292615,0
Crimson Tide,1995,116,7.3,106173,66000000,53000000,13000000,0
Crumb,1994,119,8,19354,66000000,53000000,13000000,0
Oldboy,2003,120,8.4,499664,14980005,3000000,11980005,0
The Devil's Own,1997,111,6.2,62433,97939199,86000000,11939199,1
Singin' in the Rain,1952,103,8.3,227306,13979088,2540800,11438288,0
The Adventures of Pinocchio,1996,96,5.2,5612,36394530,25000000,11394530,0
Hoop Dreams,1994,170,8.3,25412,11830611,700000,11130611,0
The Big Sleep,1946,114,7.9,82327,10682000,250000,10432000,0
Emma,1996,120,6.7,37362,15600000,6000000,9600000,0
Money Train,1995,110,5.7,39953,77224232,68000000,9224232,1
Sudden Death,1995,111,5.8,33414,44000000,35000000,9000000,0
Clueless,1995,97,6.8,195776,20700000,12000000,8700000,0
Vampire in Brooklyn,1995,100,4.6,22690,28051736,20000000,8051736,0
The Relic,1997,110,5.8,26269,48024912,40000000,8024912,0
Fight Club,1999,139,8.8,1803156,71000000,63000000,8000000,1
Drishyam,2015,163,8.2,65533,17150759,9400000,7750759,0
One Flew Over the Cuckoo's Nest,1975,133,8.7,949152,11930050,4400000,7530050,0
Johnny Mnemonic,1995,103,5.7,68634,33300000,26000000,7300000,0
Breakfast at Tiffany's,1961,115,7.6,171993,9652338,2500000,7152338,0
NausicaÃ¤ of the Valley of the Wind,1984,117,8.1,144322,7951190,1000000,6951190,1
Double Team,1997,93,4.8,32891,36700000,30000000,6700000,0
To Be or Not to Be,1942,99,8.2,33148,6980360,609000,6371360,0
Top Hat,1935,101,7.8,18314,6980360,609000,6371360,0
Taxi Driver,1976,114,8.2,756576,7638468,1300000,6338468,1
Rebecca,1940,130,8.1,130312,7592465,1288000,6304465,0
Incendies,2010,131,8.3,141773,12597210,6800000,5797210,0
Dial M for Murder,1954,105,8.2,165494,6540000,1400000,5140000,0
The Replacement Killers,1998,87,6.2,28016,35100000,30000000,5100000,0
Sunset Blvd.,1950,110,8.4,209648,5303175,1752000,3551175,1
The Maltese Falcon,1941,100,8,152798,3862960,375000,3487960,0
Deconstructing Harry,1997,96,7.4,43735,23367935,20000000,3367935,0
Supercop,1992,96,6.9,20339,4212823,900000,3312823,0
Requiem for a Dream,2000,102,8.3,746666,7390108,4500000,2890108,1
The Sting,1973,129,8.3,249441,8299101,5500000,2799101,0
The Island of Dr. Moreau,1996,96,4.5,32301,42000000,40000000,2000000,0
Boogie Nights,1997,155,7.9,248656,16700954,15000000,1700954,0
Turbo: A Power Rangers Movie,1997,99,3.7,8683,9615840,8000000,1615840,0
Children of Heaven,1997,89,8.3,61975,1628579,180000,1448579,1
The General,1926,67,8.1,78521,2180000,750000,1430000,0
Forbidden Planet,1956,98,7.6,46849,3250000,1900000,1350000,0
Paths of Glory,1957,88,8.4,185952,2092959,935000,1157959,0
Murder at 1600,1997,107,6.1,29666,41126788,40000000,1126788,0
My Neighbor Totoro,1988,86,8.2,276957,4729463,3700000,1029463,1
Bicycle Thieves,1948,89,8.3,140991,297218,133000,164218,1
On the Waterfront,1954,108,8.1,138069,678960,910000,-231040,1
The Bridge on the River Kwai,1957,161,8.1,210172,2760714,3000000,-239286,0
Ninotchka,1939,110,7.9,19948,1092000,1365000,-273000,0
Meet John Doe,1941,135,7.6,12802,1092000,1365000,-273000,0
Notorious,1946,102,8,96774,1303384,2000000,-696616,0
Warrior,2011,140,8.2,426704,24215385,25000000,-784615,0
Double Indemnity,1944,107,8.3,139152,95249,927262,-832013,0
The Shining,1980,146,8.4,935757,17469946,19000000,-1530054,0
Pinocchio,1940,88,7.4,136158,1068200,2600000,-1531800,1
Some Like It Hot,1959,121,8.2,253239,1039935,2883848,-1843913,1
Blues Brothers 2000,1998,123,4.9,32452,26000000,28000000,-2000000,0
Fantasia,1940,125,7.7,91424,187924,2280000,-2092076,0
Network,1976,121,8.1,141552,1250675,3800000,-2549325,0
For Whom the Bell Tolls,1943,170,6.9,8864,433417,3000000,-2566583,0
Highlander,1986,116,7.1,128325,12885193,16000000,-3114807,0
Everyone Says I Love You,1996,101,6.7,36283,16104765,20000000,-3895235,0
Paradise Lost: The Child Murders at Robin Hood Hills,1996,150,8.3,16043,16104765,20000000,-3895235,0
Butch Cassidy and the Sundance Kid,1969,110,8,208105,1999525,6000000,-4000475,1
The Crow: City of Angels,1996,84,4.7,19828,7500000,13000000,-5500000,0
Wyatt Earp,1994,191,6.7,47440,55952000,63000000,-7048000,0
Another Stakeout,1993,108,5.6,13640,55952000,63000000,-7048000,0
"20,000 Leagues Under the Sea",1954,127,7.2,32036,1915396,9000000,-7084604,0
The Thing,1982,109,8.1,359159,7821228,15000000,-7178772,0
Showgirls,1995,128,4.9,64617,37702961,45000000,-7297039,0
Beyond Rangoon,1995,100,6.6,5086,14700000,23000000,-8300000,0
Feast of July,1995,116,6.2,549,14700000,23000000,-8300000,1
Roommates,1995,108,6.4,1825,12400000,22000000,-9600000,0
Multiplicity,1996,117,6.1,31028,34100000,45000000,-10900000,0
Michael Collins,1996,133,7.2,30526,16900000,28000000,-11100000,0
The Ruling Class,1972,154,7.4,6037,16900000,28000000,-11100000,0
Chain Reaction,1996,107,5.7,50714,38200000,50000000,-11800000,0
Red Corner,1997,122,6.3,16814,35100000,48000000,-12900000,0
Primary Colors,1998,143,6.7,28234,52055057,65000000,-12944943,0
My Fair Lady,1964,170,7.8,90181,3047608,17000000,-13952392,1
Dark City,1998,100,7.6,192794,12821985,27000000,-14178015,0
The American President,1995,114,6.8,54770,47800000,62000000,-14200000,0
Mortal Kombat: Annihilation,1997,95,3.7,52632,15449455,30000000,-14550545,0
Bent,1997,105,7.2,8033,15449455,30000000,-14550545,0
The Hudsucker Proxy,1994,111,7.2,78787,14991000,30000000,-15009000,0
The NeverEnding Story III,1994,95,3.2,12331,1331408,17000000,-15668592,0
Kansas City,1996,116,6.3,4647,2500000,19000000,-16500000,0
The Frighteners,1996,110,7.1,84618,12600000,30000000,-17400000,0
Tank Girl,1995,104,5.4,31110,6600000,25000000,-18400000,0
Double Happiness,1994,87,7,1137,6600000,25000000,-18400000,1
The Ghost and the Darkness,1996,110,6.8,58775,36400000,55000000,-18600000,1
Down Periscope,1996,92,6.2,23331,11768149,31000000,-19231851,0
The Three Musketeers,1993,105,6.4,52476,10712024,30000000,-19287976,0
Kingpin,1996,114,6.9,80106,7200000,27000000,-19800000,0
Once Upon a Time in America,1984,229,8.4,325562,8157411,30000000,-21842589,0
Fled,1996,98,5.4,8860,2800000,25000000,-22200000,1
Terminal Velocity,1994,102,5.5,13349,26978900,50000000,-23021100,0
Fair Game,1995,91,4.3,12612,26134477,50000000,-23865523,0
Eddie,1996,100,5.2,10804,5700000,30000000,-24300000,0
The Fifth Element,1997,126,7.7,447077,67683989,93000000,-25316011,0
Shall We Dance?,1996,136,7.7,10816,67683989,93000000,-25316011,0
City Hall,1996,111,6.2,20125,13100000,40000000,-26900000,0
Rob Roy,1995,139,6.9,41591,65000,28000000,-27935000,1
The Glimmer Man,1996,91,5.4,19481,16000000,45000000,-29000000,0
Pollyanna,1960,134,7.4,9732,16000000,45000000,-29000000,0
The Shaggy Dog,1959,104,6.5,4750,16000000,45000000,-29000000,0
Dracula: Dead and Loving It,1995,88,5.9,40117,682514,30000000,-29317486,0
Now and Then,1995,100,6.8,28191,682514,30000000,-29317486,0
Mr. Wrong,1996,96,3.8,5023,682514,30000000,-29317486,0
Last Man Standing,1996,101,6.4,56203,33200000,67000000,-33800000,0
Mary Reilly,1996,108,5.8,14573,12272308,47000000,-34727692,1
The Chamber,1996,113,6,14749,7989000,50000000,-42011000,0
Speed 2: Cruise Control,1997,121,3.9,78231,115900000,160000000,-44100000,0
Braveheart,1995,178,8.3,984603,4259710,72000000,-67740290,0
Hercules,1997,93,7.3,214521,806649,85000000,-84193351,0
